x.....................xx................
x.....................xx................
x..xxxx...............xx...............x
x.............xx........x..x...xx......x
x.x.....................................
xsx......xx.......xx.x......x.xxx.xxx...
xxxxxggggxxgggggggggxxxxxxxxxxxxxxxxxxxx
